ə ʃ r ə f i:
p ɑ: ʈʰ ə k
kʰ ɪ l ɑ: n ɑ:
x ɑ: l u:
m ʊ h k ɪ m
x ə r i: d̪ i:
s ə h ɑ: b
b ə kʰ e: r n ɑ:
p ə l ɑ: s
r ʊ kʰ
m ʊ n z ɪ r
d̪ʰ ɑ: ɡ e:
ʃ ə b n
r ʊ k v ɑ:
ʈ ə r m
ə m s ɑ: r
b ɑ: ʤ
h ʊ ʃ j ɑ: r i:
i: r ɑ: n
ɪ m l ɑ: i:
b ɑ: t̪ ɪ n i:
ʊ k s ɑ: n ɑ:
ɑ: f ɑ: t̪
t̪ ə m b u:
ə f z ə l ɪ j j ə t̪
p ɔ: n e:
ʃ ə b
b ə h o: t̪
ɖʰ o: l i:
ʊ ʤ l ɑ:
t̪ ə t̪ ɑ: b ʊ q
ɪ x f ɑ:
p ʊ t̪ʰ t̪ʰ i:
s ɑ: q i:
n ɪ j ɑ: r
d̪ ɑ: ʃ t̪
s ʊ d̪ʰ
ə b ɑ:
d̪ i: b ɑ: ʤ
gʰ ə ʈ ɑ: o:
d̪ ɑ: r u:
r ə k ɑ: k ə t̪
ɣ ə m m ɑ: z
ɡ ə n
ə f ɑ: f
ʃ ə r ɑ: f ə t̪
m ʊ ʤ ɑ: h ɪ d̪
ɔ: q ɑ: f
s ʊ n d̪ ʊ s
m ə s ə l ə n
