اَشْرَفی	ə ʃ r ə f i:
پاٹَھک	p ɑ: ʈʰ ə k
کِھلانا	kʰ ɪ l ɑ: n ɑ:
خالُو	x ɑ: l u:
مُحْکِم	m ʊ h k ɪ m
خَرِیدی	x ə r i: d̪ i:
سَحاب	s ə h ɑ: b
بَکھْیرنا	b ə kʰ e: r n ɑ:
پَلاس	p ə l ɑ: s
رُکھ	r ʊ kʰ
مُنذِر	m ʊ n z ɪ r
دھاگے	d̪ʰ ɑ: ɡ e:
شَبْن	ʃ ə b n
رُکْوا	r ʊ k v ɑ:
ٹَرْم	ʈ ə r m
اَمْصار	ə m s ɑ: r
باج	b ɑ: ʤ
ہُشیاری	h ʊ ʃ j ɑ: r i:
اِیران	i: r ɑ: n
اِمْلائی	ɪ m l ɑ: i:
باطِنی	b ɑ: t̪ ɪ n i:
اُکْسانا	ʊ k s ɑ: n ɑ:
آفات	ɑ: f ɑ: t̪
تَمْبُو	t̪ ə m b u:
اَفْضَلِیَّت	ə f z ə l ɪ j j ə t̪
پَونے	p ɔ: n e:
شَب	ʃ ə b
بَہُت	b ə h o: t̪
ڈھولی	ɖʰ o: l i:
اُجلا	ʊ ʤ l ɑ:
تَطابُق	t̪ ə t̪ ɑ: b ʊ q
اِخْفا	ɪ x f ɑ:
پُتّھی	p ʊ t̪ʰ t̪ʰ i:
ساقی	s ɑ: q i:
نِیار	n ɪ j ɑ: r
داشْت	d̪ ɑ: ʃ t̪
سُدھ	s ʊ d̪ʰ
عَبا	ə b ɑ:
دِیباج	d̪ i: b ɑ: ʤ
گَھٹاؤ	gʰ ə ʈ ɑ: o:
دارُو	d̪ ɑ: r u:
رَکاکَت	r ə k ɑ: k ə t̪
غَمّاز	ɣ ə m m ɑ: z
گَن	ɡ ə n
عَفاف	ə f ɑ: f
شَرافَت	ʃ ə r ɑ: f ə t̪
مُجاہِد	m ʊ ʤ ɑ: h ɪ d̪
اَوقاف	ɔ: q ɑ: f
سُنْدُس	s ʊ n d̪ ʊ s
مَثَلاً	m ə s ə l ə n
